150
1 1 1 1 1 1 1 1 1 1 1 1 1 1
1 0 0 0 0 0 0 0 0 0 0 G:1 0 1
1 0 0 0 0 0 0 0 0 0 -1 G:1 K:2 1
1 0 0 0 1 1 1 1 1 1 1 1 1 1
1 C:225 0 0 0 0 0 0 0 0 0 0 0 1
1 1 C:225 0 0 0 0 0 0 0 0 0 0 1
1 1 1 1 1 1 1 1 1 1 0 0 0 1
1 0 0 0 0 0 0 0 0 0 0 0 C:315 1
1 0 0 0 0 0 0 0 0 0 0 C:315 1 1
1 0 0 0 1 1 1 1 1 1 1 1 1 1 1
1 C:225 0 0 0 0 0 0 0 0 0 0 G:2 0 G:2
1 1 C:225 0 0 0 0 0 0 0 0 K:1 G:2 -2 G:2
1 1 1 1 1 1 1 1 1 1 1 1 1 1 1 1