200
1 1 1 1 1 1 1 1 1 1 1 1 1 1
1 0 0 0 0 0 0 0 0 0 0 -1 0 1
1 1 0 0 1 1 1 1 1 1 1 1 1 1
1 C:225 0 0 0 0 0 0 0 0 0 0 0 1
1 1 1 1 1 1 1 1 1 1 0 0 1 1
1 0 0 0 0 0 0 0 0 0 C:315 0 0 1
1 1 0 0 1 1 1 1 1 1 1 1 1 1
1 C:225 0 0 0 0 0 0 0 0 0 -2 0 1
1 1 1 1 1 1 1 1 1 1 1 1 1 1